"filename", "language", "C++", "Markdown", "comment", "blank", "total"
"c:\Users\Jerem\projects\C-INTRO\CHP_1_C++_TEXT_BOOK\Exercises.README.md", "Markdown", 0, -74, 0, -13, -87
"c:\Users\Jerem\projects\C-INTRO\CHP_1_C++_TEXT_BOOK\Notes.README.md", "Markdown", 0, -40, 0, -29, -69
"c:\Users\Jerem\projects\C-INTRO\CHP_1_C++_TEXT_BOOK\Review_Questions.README.md", "Markdown", 0, -51, 0, -21, -72
"c:\Users\Jerem\projects\C-INTRO\CHP_1_C++_TEXT_BOOK\exerciseQuestion.cpp", "C++", -34, 0, -2, -6, -42
"c:\Users\Jerem\projects\C-INTRO\CHP_1_C++_TEXT_BOOK\hello_world.cpp", "C++", -5, 0, 0, -2, -7
"c:\Users\Jerem\projects\C-INTRO\CHP_2_C++_TEXT_BOOK\CHP_2_DRILLS.cpp", "C++", -38, 0, -2, -12, -52
"c:\Users\Jerem\projects\C-INTRO\CHP_2_C++_TEXT_BOOK\CHP_2_Exercises.README.md", "Markdown", 0, -109, 0, -50, -159
"c:\Users\Jerem\projects\C-INTRO\CHP_2_C++_TEXT_BOOK\CHP_2_Exercises.cpp", "C++", -292, 0, -32, -34, -358
"c:\Users\Jerem\projects\C-INTRO\CHP_2_C++_TEXT_BOOK\CHP_2_Notes.README.md", "Markdown", 0, -77, 0, -38, -115
"c:\Users\Jerem\projects\C-INTRO\CHP_2_C++_TEXT_BOOK\CHP_2_REVIEW_QUESTIONS.README.md", "Markdown", 0, -146, 0, -85, -231
"c:\Users\Jerem\projects\C-INTRO\CHP_2_C++_TEXT_BOOK\CHP_NOTES.cpp", "C++", -75, 0, -16, -16, -107
"c:\Users\Jerem\projects\C-INTRO\CHP_2_C++_TEXT_BOOK\DRILLS.README.md", "Markdown", 0, -17, 0, -3, -20
"c:\Users\Jerem\projects\C-INTRO\CHP_3_C++_TEXT_BOOK\CHP_3_DRILL.README.md", "Markdown", 0, -103, 0, -51, -154
"c:\Users\Jerem\projects\C-INTRO\CHP_3_C++_TEXT_BOOK\CHP_3_DRILLS.cpp", "C++", -119, 0, -28, -37, -184
"c:\Users\Jerem\projects\C-INTRO\CHP_3_C++_TEXT_BOOK\CHP_3_EXERCISES.README.md", "Markdown", 0, -29, 0, -27, -56
"c:\Users\Jerem\projects\C-INTRO\CHP_3_C++_TEXT_BOOK\CHP_3_EXERCISES.cpp", "C++", -93, 0, -17, -18, -128
"c:\Users\Jerem\projects\C-INTRO\CHP_3_C++_TEXT_BOOK\CHP_3_NOTES.README.md", "Markdown", 0, -133, 0, -31, -164
"c:\Users\Jerem\projects\C-INTRO\CHP_3_C++_TEXT_BOOK\CHP_3_NOTES.cpp", "C++", -108, 0, -25, -28, -161
"c:\Users\Jerem\projects\C-INTRO\CHP_3_C++_TEXT_BOOK\CHP_3_REVIEW_QUESTIONS.README.md", "Markdown", 0, -100, 0, -83, -183
"c:\Users\Jerem\projects\C-INTRO\CHP_3_C++_TEXT_BOOK\NOTES_ON_PHONE.README.md", "Markdown", 0, -36, 0, -40, -76
"c:\Users\Jerem\projects\C-INTRO\SAVED_LOGIC\DATA_STRUCUTRE.cpp", "C++", 74, 0, 26, 11, 111
"c:\Users\Jerem\projects\C-INTRO\SAVED_LOGIC\TERMS_AND_USEFUL.README.md", "Markdown", 0, 15, 0, 4, 19
"c:\Users\Jerem\projects\C-INTRO\SAVED_LOGIC\USEFUL_LOGIC_CHUNKS.cpp", "C++", 44, 0, 14, 7, 65
"c:\Users\Jerem\projects\C-INTRO\TERMS_AND_USEFUL.README.md", "Markdown", 0, -15, 0, -4, -19
"c:\Users\Jerem\projects\C-INTRO\TEXTBOOK\CHP_1_C++_TEXT_BOOK\Exercises.README.md", "Markdown", 0, 74, 0, 13, 87
"c:\Users\Jerem\projects\C-INTRO\TEXTBOOK\CHP_1_C++_TEXT_BOOK\Notes.README.md", "Markdown", 0, 40, 0, 29, 69
"c:\Users\Jerem\projects\C-INTRO\TEXTBOOK\CHP_1_C++_TEXT_BOOK\Review_Questions.README.md", "Markdown", 0, 51, 0, 21, 72
"c:\Users\Jerem\projects\C-INTRO\TEXTBOOK\CHP_1_C++_TEXT_BOOK\exerciseQuestion.cpp", "C++", 34, 0, 2, 6, 42
"c:\Users\Jerem\projects\C-INTRO\TEXTBOOK\CHP_1_C++_TEXT_BOOK\hello_world.cpp", "C++", 5, 0, 0, 2, 7
"c:\Users\Jerem\projects\C-INTRO\TEXTBOOK\CHP_2_C++_TEXT_BOOK\CHP_2_DRILLS.cpp", "C++", 38, 0, 2, 12, 52
"c:\Users\Jerem\projects\C-INTRO\TEXTBOOK\CHP_2_C++_TEXT_BOOK\CHP_2_Exercises.README.md", "Markdown", 0, 109, 0, 50, 159
"c:\Users\Jerem\projects\C-INTRO\TEXTBOOK\CHP_2_C++_TEXT_BOOK\CHP_2_Exercises.cpp", "C++", 292, 0, 32, 34, 358
"c:\Users\Jerem\projects\C-INTRO\TEXTBOOK\CHP_2_C++_TEXT_BOOK\CHP_2_Notes.README.md", "Markdown", 0, 77, 0, 38, 115
"c:\Users\Jerem\projects\C-INTRO\TEXTBOOK\CHP_2_C++_TEXT_BOOK\CHP_2_REVIEW_QUESTIONS.README.md", "Markdown", 0, 146, 0, 85, 231
"c:\Users\Jerem\projects\C-INTRO\TEXTBOOK\CHP_2_C++_TEXT_BOOK\CHP_NOTES.cpp", "C++", 75, 0, 16, 16, 107
"c:\Users\Jerem\projects\C-INTRO\TEXTBOOK\CHP_2_C++_TEXT_BOOK\DRILLS.README.md", "Markdown", 0, 17, 0, 3, 20
"c:\Users\Jerem\projects\C-INTRO\TEXTBOOK\CHP_3_C++_TEXT_BOOK\CHP_3_DRILL.README.md", "Markdown", 0, 103, 0, 51, 154
"c:\Users\Jerem\projects\C-INTRO\TEXTBOOK\CHP_3_C++_TEXT_BOOK\CHP_3_DRILLS.cpp", "C++", 119, 0, 28, 37, 184
"c:\Users\Jerem\projects\C-INTRO\TEXTBOOK\CHP_3_C++_TEXT_BOOK\CHP_3_EXERCISES.README.md", "Markdown", 0, 35, 0, 33, 68
"c:\Users\Jerem\projects\C-INTRO\TEXTBOOK\CHP_3_C++_TEXT_BOOK\CHP_3_EXERCISES.cpp", "C++", 211, 0, 50, 56, 317
"c:\Users\Jerem\projects\C-INTRO\TEXTBOOK\CHP_3_C++_TEXT_BOOK\CHP_3_NOTES.README.md", "Markdown", 0, 133, 0, 31, 164
"c:\Users\Jerem\projects\C-INTRO\TEXTBOOK\CHP_3_C++_TEXT_BOOK\CHP_3_NOTES.cpp", "C++", 108, 0, 25, 28, 161
"c:\Users\Jerem\projects\C-INTRO\TEXTBOOK\CHP_3_C++_TEXT_BOOK\CHP_3_REVIEW_QUESTIONS.README.md", "Markdown", 0, 100, 0, 83, 183
"c:\Users\Jerem\projects\C-INTRO\TEXTBOOK\CHP_3_C++_TEXT_BOOK\NOTES_ON_PHONE.README.md", "Markdown", 0, 36, 0, 40, 76
"c:\Users\Jerem\projects\C-INTRO\USEFUL_LOGIC_CHUNKS.cpp", "C++", -44, 0, -8, -5, -57
"Total", "-", 192, 6, 65, 57, 320